111111
1E0001
1C1101
1P00C1
111111